WhAdhaFKPAquery	WhAdhaFKPAcorpus	1
PpSTqqrqypquery	PpSTqqrqypcorpus	1
yMK0INaHCAquery	yMK0INaHCAcorpus	1
ySIUAicCRfquery	ySIUAicCRfcorpus	1
mOEpkrIPeYquery	mOEpkrIPeYcorpus	1
dpOGqEiJesquery	dpOGqEiJescorpus	1
V0chOPDvpBquery	V0chOPDvpBcorpus	1
EwFEQ6NQdpquery	EwFEQ6NQdpcorpus	1
cuOrEovdyVquery	cuOrEovdyVcorpus	1
zPSK3gRCIRquery	zPSK3gRCIRcorpus	1
lK6NEksVAzquery	lK6NEksVAzcorpus	1
HEeAckpiVVquery	HEeAckpiVVcorpus	1
GSOlGHkEHjquery	GSOlGHkEHjcorpus	1
RyXqNgTaq3query	RyXqNgTaq3corpus	1
SaWyGkw3Sqquery	SaWyGkw3Sqcorpus	1
vkGfegWhpOquery	vkGfegWhpOcorpus	1
YtfMTiZHCZquery	YtfMTiZHCZcorpus	1
NmrNiWwbEFquery	NmrNiWwbEFcorpus	1
zKIiWGeHGLquery	zKIiWGeHGLcorpus	1
mAaY2PODiUquery	mAaY2PODiUcorpus	1
FRQtuKJxpwquery	FRQtuKJxpwcorpus	1
ghRhvJCaFnquery	ghRhvJCaFncorpus	1
vXgLtx3GKequery	vXgLtx3GKecorpus	1
hzlucIVkmrquery	hzlucIVkmrcorpus	1
RFmXElgTQoquery	RFmXElgTQocorpus	1
AdUAzlcGDEquery	AdUAzlcGDEcorpus	1
YaYQMrKyaFquery	YaYQMrKyaFcorpus	1
HMnOQOuecnquery	HMnOQOuecncorpus	1
LFhcjdkMEZquery	LFhcjdkMEZcorpus	1
LqGVagzRTmquery	LqGVagzRTmcorpus	1
RGPEFnKyQKquery	RGPEFnKyQKcorpus	1
WPsFGerjQoquery	WPsFGerjQocorpus	1
QeXntKXCeTquery	QeXntKXCeTcorpus	1
clTPqSHMcDquery	clTPqSHMcDcorpus	1
SGQSAfdKSfquery	SGQSAfdKSfcorpus	1
xXVJbQWbMXquery	xXVJbQWbMXcorpus	1
JNiOwzjfvPquery	JNiOwzjfvPcorpus	1
ich7jWp6qXquery	ich7jWp6qXcorpus	1
VUTmqhiSZlquery	VUTmqhiSZlcorpus	1
ThhDWbVsyOquery	ThhDWbVsyOcorpus	1
Nsilvaphrqquery	Nsilvaphrqcorpus	1
XxLmDUJAnNquery	XxLmDUJAnNcorpus	1
rWQoRVGLKNquery	rWQoRVGLKNcorpus	1
CFeOKTXEtlquery	CFeOKTXEtlcorpus	1
yzRPLEOabtquery	yzRPLEOabtcorpus	1
bRUxkJyJ4Cquery	bRUxkJyJ4Ccorpus	1
AYxwGc4Cbtquery	AYxwGc4Cbtcorpus	1
VaSskYjqdPquery	VaSskYjqdPcorpus	1
DwiJcMKDiBquery	DwiJcMKDiBcorpus	1
KLSdMTetHkquery	KLSdMTetHkcorpus	1
yHaWB6waeyquery	yHaWB6waeycorpus	1
ouzdknmgXfquery	ouzdknmgXfcorpus	1
I7yQZAGxeiquery	I7yQZAGxeicorpus	1
aPvtgVQXRWquery	aPvtgVQXRWcorpus	1
TgyvUgYBIOquery	TgyvUgYBIOcorpus	1
gieTTBTBYYquery	gieTTBTBYYcorpus	1
KlGHvQjfyaquery	KlGHvQjfyacorpus	1
oqdNKNHERbquery	oqdNKNHERbcorpus	1
igTnnlviVDquery	igTnnlviVDcorpus	1
EiKwQaVzWHquery	EiKwQaVzWHcorpus	1
BYjYKJlBYkquery	BYjYKJlBYkcorpus	1
GMINZRJgRmquery	GMINZRJgRmcorpus	1
GLDEhAwxBKquery	GLDEhAwxBKcorpus	1
YTFPTiXtZYquery	YTFPTiXtZYcorpus	1
VkMHZuuYeHquery	VkMHZuuYeHcorpus	1
SXtiEMsGhgquery	SXtiEMsGhgcorpus	1
jISQDVjwTHquery	jISQDVjwTHcorpus	1
cghYCgoXTWquery	cghYCgoXTWcorpus	1
qsgqf5jFZmquery	qsgqf5jFZmcorpus	1
hgDlmfnoscquery	hgDlmfnosccorpus	1
kojFWHsuD8query	kojFWHsuD8corpus	1
HaaRfyaTUaquery	HaaRfyaTUacorpus	1
EXFmliZbayquery	EXFmliZbaycorpus	1
uYaHCYxJrsquery	uYaHCYxJrscorpus	1
LiuOiQcWpmquery	LiuOiQcWpmcorpus	1
mGlxFmIjAZquery	mGlxFmIjAZcorpus	1
QJNU6BRgTPquery	QJNU6BRgTPcorpus	1
DIWMkQqXOtquery	DIWMkQqXOtcorpus	1
MjKIKLRSMSquery	MjKIKLRSMScorpus	1
pjWQIfeqIPquery	pjWQIfeqIPcorpus	1
EFElVybpqqquery	EFElVybpqqcorpus	1
nGUdsREIXdquery	nGUdsREIXdcorpus	1
ffVurMUlUdquery	ffVurMUlUdcorpus	1
hjIjDfpWZRquery	hjIjDfpWZRcorpus	1
qKzVReWPLRquery	qKzVReWPLRcorpus	1
xrClivdGTvquery	xrClivdGTvcorpus	1
hvYBGGqXvhquery	hvYBGGqXvhcorpus	1
zLxufeLKuAquery	zLxufeLKuAcorpus	1
BNTyrjeMr0query	BNTyrjeMr0corpus	1
PhkVorBKOequery	PhkVorBKOecorpus	1
oPQ7TMUWuCquery	oPQ7TMUWuCcorpus	1
4WLEvzuYVLquery	4WLEvzuYVLcorpus	1
seTYomKZ9Rquery	seTYomKZ9Rcorpus	1
ddyjPUZuXlquery	ddyjPUZuXlcorpus	1
zmIY4J4CNBquery	zmIY4J4CNBcorpus	1
UrrRBbFf7qquery	UrrRBbFf7qcorpus	1
ZJCSKorwBnquery	ZJCSKorwBncorpus	1
tlNAsmlfvSquery	tlNAsmlfvScorpus	1
PWCWKayaczquery	PWCWKayaczcorpus	1
rXZZnzGqEzquery	rXZZnzGqEzcorpus	1
NnODFrKsUEquery	NnODFrKsUEcorpus	1
DcwBcVimsCquery	DcwBcVimsCcorpus	1
RKHEPWWhmsquery	RKHEPWWhmscorpus	1
LSWEroCrwJquery	LSWEroCrwJcorpus	1
pKmSczQsBGquery	pKmSczQsBGcorpus	1
wzOUVkYYVpquery	wzOUVkYYVpcorpus	1
rQYDABMPZaquery	rQYDABMPZacorpus	1
YiPpCPkhbyquery	YiPpCPkhbycorpus	1
YsPheqoWiequery	YsPheqoWiecorpus	1
aMDliXOeSWquery	aMDliXOeSWcorpus	1
FrDZBCdsenquery	FrDZBCdsencorpus	1
LtGHaDgLdjquery	LtGHaDgLdjcorpus	1
nnFTCdueUcquery	nnFTCdueUccorpus	1
cHkG8Qucxgquery	cHkG8Qucxgcorpus	1
TUnOw6xfFcquery	TUnOw6xfFccorpus	1
QeAJEyXJv0query	QeAJEyXJv0corpus	1
LOLjGkIDs4query	LOLjGkIDs4corpus	1
CrgoTzmyjJquery	CrgoTzmyjJcorpus	1
NKlfTbYYpWquery	NKlfTbYYpWcorpus	1
ySLBwYJZxjquery	ySLBwYJZxjcorpus	1
VVBsrtqpvfquery	VVBsrtqpvfcorpus	1
ullUuerCsaquery	ullUuerCsacorpus	1
xRuvFGPKdMquery	xRuvFGPKdMcorpus	1
QpTeaFeuZKquery	QpTeaFeuZKcorpus	1
fGAhtQFKBcquery	fGAhtQFKBccorpus	1
DC2OOYGadBquery	DC2OOYGadBcorpus	1
sHUXHZarzSquery	sHUXHZarzScorpus	1
lqdUUKgoklquery	lqdUUKgoklcorpus	1
uDLBQQEKFbquery	uDLBQQEKFbcorpus	1
MBBOPzmXJVquery	MBBOPzmXJVcorpus	1
iaOmdipMMRquery	iaOmdipMMRcorpus	1
KSQajfIGdPquery	KSQajfIGdPcorpus	1
VnJVKWukWgquery	VnJVKWukWgcorpus	1
ODBirkz1Siquery	ODBirkz1Sicorpus	1
xmEkOIstqnquery	xmEkOIstqncorpus	1
hDZmSkktlXquery	hDZmSkktlXcorpus	1
yTFiVTqBbbquery	yTFiVTqBbbcorpus	1
qHeEVt2aZAquery	qHeEVt2aZAcorpus	1
xqcUpyqXKCquery	xqcUpyqXKCcorpus	1
cfXEFUrkIFquery	cfXEFUrkIFcorpus	1
sDCUOKGtRequery	sDCUOKGtRecorpus	1
cZKfoOiXIlquery	cZKfoOiXIlcorpus	1
sAcC9UnHVHquery	sAcC9UnHVHcorpus	1
qXkjOLNeCwquery	qXkjOLNeCwcorpus	1
RphaovvUinquery	RphaovvUincorpus	1
OzWuggWzHmquery	OzWuggWzHmcorpus	1
t4rltykZfhquery	t4rltykZfhcorpus	1
xImJ7CDQujquery	xImJ7CDQujcorpus	1
rQsiJlDHwPquery	rQsiJlDHwPcorpus	1
AUMJApncwDquery	AUMJApncwDcorpus	1
RKHxthXosmquery	RKHxthXosmcorpus	1
HWNOQGYPenquery	HWNOQGYPencorpus	1
AUrAdfcgygquery	AUrAdfcgygcorpus	1
nJRjXRISLVquery	nJRjXRISLVcorpus	1
niblyRKpqQquery	niblyRKpqQcorpus	1
L9ulRLBeptquery	L9ulRLBeptcorpus	1
auKzNlrZOTquery	auKzNlrZOTcorpus	1
VBxEJbITvQquery	VBxEJbITvQcorpus	1
fNtHTjiJgmquery	fNtHTjiJgmcorpus	1
CpTMsbSGNpquery	CpTMsbSGNpcorpus	1
yubxWioSXwquery	yubxWioSXwcorpus	1
JbhNgfYmilquery	JbhNgfYmilcorpus	1
vrNPDXjwAQquery	vrNPDXjwAQcorpus	1
XMOefwSiITquery	XMOefwSiITcorpus	1
AhyFvgbvDCquery	AhyFvgbvDCcorpus	1
NE1fECOcLcquery	NE1fECOcLccorpus	1
xYiVPGPKigquery	xYiVPGPKigcorpus	1
TEXaYxLEFMquery	TEXaYxLEFMcorpus	1
RTLPFCsuJkquery	RTLPFCsuJkcorpus	1
uOHmdRVwZOquery	uOHmdRVwZOcorpus	1
GxupRZ9swuquery	GxupRZ9swucorpus	1
leWJzAfmoAquery	leWJzAfmoAcorpus	1
siZerliPURquery	siZerliPURcorpus	1
qmMCZgXNGLquery	qmMCZgXNGLcorpus	1
gOcXqrKqeLquery	gOcXqrKqeLcorpus	1
wRNpKOmUVBquery	wRNpKOmUVBcorpus	1
lFXwiKhaNPquery	lFXwiKhaNPcorpus	1
COLFKExveoquery	COLFKExveocorpus	1
yXjtOVlkUpquery	yXjtOVlkUpcorpus	1
UtBhrKgjPSquery	UtBhrKgjPScorpus	1
iFiWcIDKAtquery	iFiWcIDKAtcorpus	1
nxeQPKAWpRquery	nxeQPKAWpRcorpus	1
PFcjdrvqjNquery	PFcjdrvqjNcorpus	1
AWghnpGhiAquery	AWghnpGhiAcorpus	1
pqQipjPpSxquery	pqQipjPpSxcorpus	1
ZaprsuxW6yquery	ZaprsuxW6ycorpus	1
WqOlErKvyJquery	WqOlErKvyJcorpus	1
FJeBicBVUtquery	FJeBicBVUtcorpus	1
MkuYLlYIZsquery	MkuYLlYIZscorpus	1
HJfYnUmmGCquery	HJfYnUmmGCcorpus	1
tLqcxVTMQequery	tLqcxVTMQecorpus	1
jFfABsivejquery	jFfABsivejcorpus	1
sJYdXpcvixquery	sJYdXpcvixcorpus	1
NVwBINOZsbquery	NVwBINOZsbcorpus	1
IVEViISIWZquery	IVEViISIWZcorpus	1
vXELsnHdYPquery	vXELsnHdYPcorpus	1
jzaAjNIaH5query	jzaAjNIaH5corpus	1
wVGLdsLnWoquery	wVGLdsLnWocorpus	1
CqmhbeDSQXquery	CqmhbeDSQXcorpus	1
HJgTdtNkatquery	HJgTdtNkatcorpus	1
GVZFNWieVzquery	GVZFNWieVzcorpus	1
hGYoMKnkxsquery	hGYoMKnkxscorpus	1
PWWwumB1uiquery	PWWwumB1uicorpus	1
FUaZhjcwuSquery	FUaZhjcwuScorpus	1
NayDuOQDhcquery	NayDuOQDhccorpus	1
lXVeunqmWGquery	lXVeunqmWGcorpus	1
SlcFhFZnYVquery	SlcFhFZnYVcorpus	1
ihWortmiQJquery	ihWortmiQJcorpus	1
pKbmpJcSnBquery	pKbmpJcSnBcorpus	1
YgroVRZytDquery	YgroVRZytDcorpus	1
pobUsIZGihquery	pobUsIZGihcorpus	1
zOlmCiFvcNquery	zOlmCiFvcNcorpus	1
gThNtbmasbquery	gThNtbmasbcorpus	1
n7SM8dBUlGquery	n7SM8dBUlGcorpus	1
fRGmcLmap1query	fRGmcLmap1corpus	1
vthSvLghXCquery	vthSvLghXCcorpus	1
DyUZFtgtoNquery	DyUZFtgtoNcorpus	1
xGApdYGsxdquery	xGApdYGsxdcorpus	1
hpaSxrkvTnquery	hpaSxrkvTncorpus	1
ioXKeTGPIoquery	ioXKeTGPIocorpus	1
gmMHArkbYuquery	gmMHArkbYucorpus	1
vXYdvhZOGYquery	vXYdvhZOGYcorpus	1
LehegFjpDVquery	LehegFjpDVcorpus	1
yosTUcCOnbquery	yosTUcCOnbcorpus	1
riazWWhbzbquery	riazWWhbzbcorpus	1
RGduoavyYVquery	RGduoavyYVcorpus	1
fEZcrUyCOOquery	fEZcrUyCOOcorpus	1
mmO3hpFVWrquery	mmO3hpFVWrcorpus	1
bfaXIKxAOBquery	bfaXIKxAOBcorpus	1
Ihl1vogcywquery	Ihl1vogcywcorpus	1
OimvXBofBsquery	OimvXBofBscorpus	1
EnoccRLpqxquery	EnoccRLpqxcorpus	1
fjEGOvKqoEquery	fjEGOvKqoEcorpus	1
4EoeTmhTsNquery	4EoeTmhTsNcorpus	1
TVDwjbpcpxquery	TVDwjbpcpxcorpus	1
udUQ0waAaFquery	udUQ0waAaFcorpus	1
UXyYglydBYquery	UXyYglydBYcorpus	1
YSl8ulWPANquery	YSl8ulWPANcorpus	1
vXlEcpBTLvquery	vXlEcpBTLvcorpus	1
llIpyeZLVHquery	llIpyeZLVHcorpus	1
CdqXMzfNJIquery	CdqXMzfNJIcorpus	1
gQa8faOQmtquery	gQa8faOQmtcorpus	1
VASwCAPRhUquery	VASwCAPRhUcorpus	1
yLUGAtTHkMquery	yLUGAtTHkMcorpus	1
RSVGsevJdIquery	RSVGsevJdIcorpus	1
QqmmgOYYMnquery	QqmmgOYYMncorpus	1
nFPMarkoiIquery	nFPMarkoiIcorpus	1
ShYqBWjWiuquery	ShYqBWjWiucorpus	1
IinyswWeV1query	IinyswWeV1corpus	1
UqgoPBGbSJquery	UqgoPBGbSJcorpus	1
XmQiTspsiaquery	XmQiTspsiacorpus	1
siSgCbgq4tquery	siSgCbgq4tcorpus	1
seZHQkDWcSquery	seZHQkDWcScorpus	1
VpyWnHindiquery	VpyWnHindicorpus	1
nNNWdw4dLqquery	nNNWdw4dLqcorpus	1
oDDmyLxOMVquery	oDDmyLxOMVcorpus	1
mJarTO4Dbpquery	mJarTO4Dbpcorpus	1
VSeJTvVCkCquery	VSeJTvVCkCcorpus	1
Jt3ncqIbvhquery	Jt3ncqIbvhcorpus	1
zEqyIgSbuiquery	zEqyIgSbuicorpus	1
pKVYIzFSWTquery	pKVYIzFSWTcorpus	1
pOotZsfMnlquery	pOotZsfMnlcorpus	1
Wjq0TScYjgquery	Wjq0TScYjgcorpus	1
dDPqNqrlTkquery	dDPqNqrlTkcorpus	1
JYVKwgVITVquery	JYVKwgVITVcorpus	1
OfBzrPaXrSquery	OfBzrPaXrScorpus	1
rngFpmwxuYquery	rngFpmwxuYcorpus	1
2NEIwtWTdIquery	2NEIwtWTdIcorpus	1
QIEJAhuLuoquery	QIEJAhuLuocorpus	1
JrbynNGBoaquery	JrbynNGBoacorpus	1
OBA7xilHYoquery	OBA7xilHYocorpus	1
SbXQNdeaGmquery	SbXQNdeaGmcorpus	1
oYaDMSiDkRquery	oYaDMSiDkRcorpus	1
WYcWjigTjOquery	WYcWjigTjOcorpus	1
QgyabMfHCFquery	QgyabMfHCFcorpus	1
zaVWjHcocBquery	zaVWjHcocBcorpus	1
wPnSLRAAoMquery	wPnSLRAAoMcorpus	1
UYUkgcuMutquery	UYUkgcuMutcorpus	1
KMBuYHlN1Equery	KMBuYHlN1Ecorpus	1
SnLJw8lGbdquery	SnLJw8lGbdcorpus	1
SvfcmdrJeEquery	SvfcmdrJeEcorpus	1
2IEnJaOscxquery	2IEnJaOscxcorpus	1
nHbUtSxFwpquery	nHbUtSxFwpcorpus	1
AFfLzRIFzfquery	AFfLzRIFzfcorpus	1
kudWAMqKJXquery	kudWAMqKJXcorpus	1
QXlnwVDWJAquery	QXlnwVDWJAcorpus	1
5KuzEOYszPquery	5KuzEOYszPcorpus	1
cfjpMftCOxquery	cfjpMftCOxcorpus	1
sKyHBZJkXGquery	sKyHBZJkXGcorpus	1
LUMQgfmpRpquery	LUMQgfmpRpcorpus	1
GPktJDQpVHquery	GPktJDQpVHcorpus	1
xBazgRvoQAquery	xBazgRvoQAcorpus	1
kOqiNKUNsDquery	kOqiNKUNsDcorpus	1
lMXvKpGsJLquery	lMXvKpGsJLcorpus	1
xRLGrsBJujquery	xRLGrsBJujcorpus	1
GuqnUoRnyaquery	GuqnUoRnyacorpus	1
QawfRDCtKgquery	QawfRDCtKgcorpus	1
aXTFLTweqbquery	aXTFLTweqbcorpus	1
BHkeQVIbMSquery	BHkeQVIbMScorpus	1
nIKNGIDNPvquery	nIKNGIDNPvcorpus	1
jHuVrSyu9mquery	jHuVrSyu9mcorpus	1
4JlhpeNClIquery	4JlhpeNClIcorpus	1
kyLawgStKAquery	kyLawgStKAcorpus	1
DGlymqhOPLquery	DGlymqhOPLcorpus	1
OKFrWTPSdxquery	OKFrWTPSdxcorpus	1
Ale5pAylLAquery	Ale5pAylLAcorpus	1
9XgZkJmhjpquery	9XgZkJmhjpcorpus	1
tcuAslUPSJquery	tcuAslUPSJcorpus	1
dvqGoCuJMQquery	dvqGoCuJMQcorpus	1
brXJETMqITquery	brXJETMqITcorpus	1
HKIqxXEaCPquery	HKIqxXEaCPcorpus	1
WzFxeQrbkgquery	WzFxeQrbkgcorpus	1
NDeEPPLkFqquery	NDeEPPLkFqcorpus	1
zlVeKDTiSgquery	zlVeKDTiSgcorpus	1
GZnmTEgnYUquery	GZnmTEgnYUcorpus	1
RevAg0TzVnquery	RevAg0TzVncorpus	1
HRdUDfBxRgquery	HRdUDfBxRgcorpus	1
EaNDGGsRzkquery	EaNDGGsRzkcorpus	1
jTJWBiNyLrquery	jTJWBiNyLrcorpus	1
p0EkIsXycIquery	p0EkIsXycIcorpus	1
GJlskanqhSquery	GJlskanqhScorpus	1
jjXYSaovxGquery	jjXYSaovxGcorpus	1
DVIhJOvVCzquery	DVIhJOvVCzcorpus	1
KjqoPqKCbiquery	KjqoPqKCbicorpus	1
tZCDrYtWaFquery	tZCDrYtWaFcorpus	1
yVUsykSpHAquery	yVUsykSpHAcorpus	1
PrMaYFWJxqquery	PrMaYFWJxqcorpus	1
cFoIQELtLYquery	cFoIQELtLYcorpus	1
YpppD4WXnYquery	YpppD4WXnYcorpus	1
MyTacEUaRpquery	MyTacEUaRpcorpus	1
OoZKVbBxnFquery	OoZKVbBxnFcorpus	1
kqsx6aabiJquery	kqsx6aabiJcorpus	1
gScOzKXWonquery	gScOzKXWoncorpus	1
SyTVCkGtePquery	SyTVCkGtePcorpus	1
aZVVAevxFnquery	aZVVAevxFncorpus	1
AwGrVfTbUQquery	AwGrVfTbUQcorpus	1
SsQpQb9PUAquery	SsQpQb9PUAcorpus	1
TVgEukvJfkquery	TVgEukvJfkcorpus	1
yvyAghrO7Bquery	yvyAghrO7Bcorpus	1
XOyyJitmOGquery	XOyyJitmOGcorpus	1
KXwuetclS9query	KXwuetclS9corpus	1
kOBAMQWqNAquery	kOBAMQWqNAcorpus	1
sgjmPDUtEpquery	sgjmPDUtEpcorpus	1
OneeeHkgVEquery	OneeeHkgVEcorpus	1
DbKPuXrEbUquery	DbKPuXrEbUcorpus	1
XEqPcEzDGfquery	XEqPcEzDGfcorpus	1
zftjPmAISvquery	zftjPmAISvcorpus	1
yQCDiHFdjIquery	yQCDiHFdjIcorpus	1
ifyPtimCEVquery	ifyPtimCEVcorpus	1
wyfmcpayXBquery	wyfmcpayXBcorpus	1
GnXtnpCdrZquery	GnXtnpCdrZcorpus	1
VnFhyuxUNPquery	VnFhyuxUNPcorpus	1
uTPoPHqFNZquery	uTPoPHqFNZcorpus	1
d7HbCfgQnoquery	d7HbCfgQnocorpus	1
8wlOBoOuCGquery	8wlOBoOuCGcorpus	1
qDwvBiQZznquery	qDwvBiQZzncorpus	1
pDOdDGYXOhquery	pDOdDGYXOhcorpus	1
ZizawEOJxequery	ZizawEOJxecorpus	1
kxnL2KSYcsquery	kxnL2KSYcscorpus	1
SOWUmWsuULquery	SOWUmWsuULcorpus	1
EwLsGqZTtoquery	EwLsGqZTtocorpus	1
uMEiTrLXVequery	uMEiTrLXVecorpus	1
udJabtvMiSquery	udJabtvMiScorpus	1
yUaWihLVXlquery	yUaWihLVXlcorpus	1
GVhASbxJGSquery	GVhASbxJGScorpus	1
jgAhWEqzhxquery	jgAhWEqzhxcorpus	1
yKwenQoUCwquery	yKwenQoUCwcorpus	1
hjDpQYXyErquery	hjDpQYXyErcorpus	1
YirbzSOdkEquery	YirbzSOdkEcorpus	1
btKYQUdLiIquery	btKYQUdLiIcorpus	1
AoPviYqdvIquery	AoPviYqdvIcorpus	1
LyQTgyNhWEquery	LyQTgyNhWEcorpus	1
xPxgyhfgniquery	xPxgyhfgnicorpus	1
gVwqvhiaWDquery	gVwqvhiaWDcorpus	1
cF2PyBn0lmquery	cF2PyBn0lmcorpus	1
egglYlLPDVquery	egglYlLPDVcorpus	1
ldIhFHdRktquery	ldIhFHdRktcorpus	1
jwZtOlgZBRquery	jwZtOlgZBRcorpus	1
juaIxUyXpHquery	juaIxUyXpHcorpus	1
nGGNCdyFhSquery	nGGNCdyFhScorpus	1
zkwYquGPuDquery	zkwYquGPuDcorpus	1
cmvcJiIPOyquery	cmvcJiIPOycorpus	1
MjNqfPFebYquery	MjNqfPFebYcorpus	1
PHBUcjgMGXquery	PHBUcjgMGXcorpus	1
KfRjUily0yquery	KfRjUily0ycorpus	1
tXjDusjibsquery	tXjDusjibscorpus	1
MkVdoPAvyvquery	MkVdoPAvyvcorpus	1
DurjLkkbVwquery	DurjLkkbVwcorpus	1
xvSCWgAnggquery	xvSCWgAnggcorpus	1
evZeQuowpIquery	evZeQuowpIcorpus	1
stoCHXbaCAquery	stoCHXbaCAcorpus	1
LdgigHKxBBquery	LdgigHKxBBcorpus	1
OaeuxSjIzdquery	OaeuxSjIzdcorpus	1
kGAGlVVmxxquery	kGAGlVVmxxcorpus	1
MxDjNw7NCHquery	MxDjNw7NCHcorpus	1
nVfChObOtbquery	nVfChObOtbcorpus	1
ZAyWURNUNTquery	ZAyWURNUNTcorpus	1
hEdpsNlVDCquery	hEdpsNlVDCcorpus	1
jZDUxYWOUyquery	jZDUxYWOUycorpus	1
XnQMUpVpdqquery	XnQMUpVpdqcorpus	1
YhmvTwVMF7query	YhmvTwVMF7corpus	1
YQuVmGbfA8query	YQuVmGbfA8corpus	1
QyMUS1V7mIquery	QyMUS1V7mIcorpus	1
KAdBPnbIaRquery	KAdBPnbIaRcorpus	1
T6fABrZwSuquery	T6fABrZwSucorpus	1
WgHTxQbpGPquery	WgHTxQbpGPcorpus	1
r6y6QokzUoquery	r6y6QokzUocorpus	1
BHbqHCxuUyquery	BHbqHCxuUycorpus	1
qtYMvisOMrquery	qtYMvisOMrcorpus	1
UHlBndQZjequery	UHlBndQZjecorpus	1
XPRDEEDfcoquery	XPRDEEDfcocorpus	1
lvoyKYLGBqquery	lvoyKYLGBqcorpus	1
CdoqOilLknquery	CdoqOilLkncorpus	1
fhEypUhhjpquery	fhEypUhhjpcorpus	1
tylLfIaHKTquery	tylLfIaHKTcorpus	1
ZVPGLpcKphquery	ZVPGLpcKphcorpus	1
hOYgmjJgqJquery	hOYgmjJgqJcorpus	1
QKJUdfgH6Qquery	QKJUdfgH6Qcorpus	1
pPwdAIDZsOquery	pPwdAIDZsOcorpus	1
jSCggle7twquery	jSCggle7twcorpus	1
fTdfGQbIUrquery	fTdfGQbIUrcorpus	1
eRZRmsbenGquery	eRZRmsbenGcorpus	1
WthwTnESZlquery	WthwTnESZlcorpus	1
GoYRpCTgfKquery	GoYRpCTgfKcorpus	1
xdeZHbDODSquery	xdeZHbDODScorpus	1
PUhGcEOtIuquery	PUhGcEOtIucorpus	1
JJqYxqoEDGquery	JJqYxqoEDGcorpus	1
gkIgG3Chkiquery	gkIgG3Chkicorpus	1
CizuElPVUOquery	CizuElPVUOcorpus	1
iYBqHrOnfiquery	iYBqHrOnficorpus	1
LQquJnyNfTquery	LQquJnyNfTcorpus	1
UXzDLZHMIJquery	UXzDLZHMIJcorpus	1
FvefpAEZhXquery	FvefpAEZhXcorpus	1
LhWBSCjkfDquery	LhWBSCjkfDcorpus	1
CXGOiGVmaVquery	CXGOiGVmaVcorpus	1
kelsIxPdnBquery	kelsIxPdnBcorpus	1
gEWuspelDxquery	gEWuspelDxcorpus	1
ZVSrE1pHxFquery	ZVSrE1pHxFcorpus	1
yWhny1fUIiquery	yWhny1fUIicorpus	1
qveykHPpS8query	qveykHPpS8corpus	1
aUPrTcrHEcquery	aUPrTcrHEccorpus	1
UbQAvBxTsiquery	UbQAvBxTsicorpus	1
eEVWBQDwPGquery	eEVWBQDwPGcorpus	1
dibuCDUgzmquery	dibuCDUgzmcorpus	1
VSOidoePvCquery	VSOidoePvCcorpus	1
vogFbIJFwkquery	vogFbIJFwkcorpus	1
xOCUiyT5xOquery	xOCUiyT5xOcorpus	1
AOiFmbMX5Jquery	AOiFmbMX5Jcorpus	1
LrXuXWzQifquery	LrXuXWzQifcorpus	1
oYrZXqPPKcquery	oYrZXqPPKccorpus	1
XQFkaPPkQXquery	XQFkaPPkQXcorpus	1
lmGKCAtKtxquery	lmGKCAtKtxcorpus	1
pSqjMxXXMPquery	pSqjMxXXMPcorpus	1
EHtMTMImOrquery	EHtMTMImOrcorpus	1
CDMnYXvhusquery	CDMnYXvhuscorpus	1
ppReeSMOJzquery	ppReeSMOJzcorpus	1
ufJnWOaRXequery	ufJnWOaRXecorpus	1
BF1ghhzTnRquery	BF1ghhzTnRcorpus	1
vk5tTzCbCZquery	vk5tTzCbCZcorpus	1
HNNWSiLhlxquery	HNNWSiLhlxcorpus	1
BOsiLklYvOquery	BOsiLklYvOcorpus	1
0xABJBgvvIquery	0xABJBgvvIcorpus	1
ObpNMJKKmxquery	ObpNMJKKmxcorpus	1
ru3E1QVcTzquery	ru3E1QVcTzcorpus	1
cujDtedwPxquery	cujDtedwPxcorpus	1
zSwckLgMYWquery	zSwckLgMYWcorpus	1
tdHqzDUDkzquery	tdHqzDUDkzcorpus	1
JOHJBZuyaIquery	JOHJBZuyaIcorpus	1
Va9ldQndcSquery	Va9ldQndcScorpus	1
FqBrVbNRPXquery	FqBrVbNRPXcorpus	1
YPrKIbeiATquery	YPrKIbeiATcorpus	1
NnfljhiZNyquery	NnfljhiZNycorpus	1
NLHoxNtNTHquery	NLHoxNtNTHcorpus	1
nhMOWfEKDSquery	nhMOWfEKDScorpus	1
tSABaydabDquery	tSABaydabDcorpus	1
TwitTPqbaFquery	TwitTPqbaFcorpus	1
BDwylXvhjYquery	BDwylXvhjYcorpus	1
evDlrdGLIiquery	evDlrdGLIicorpus	1
aagmreVRgYquery	aagmreVRgYcorpus	1
eBCniARZzzquery	eBCniARZzzcorpus	1
iJshUnocAHquery	iJshUnocAHcorpus	1
kYXFMJpFYGquery	kYXFMJpFYGcorpus	1
ZeASHXMQJnquery	ZeASHXMQJncorpus	1
LhJiekIzgDquery	LhJiekIzgDcorpus	1
MWnmaRIxaOquery	MWnmaRIxaOcorpus	1
rVZMnZYltcquery	rVZMnZYltccorpus	1
HpvPXFGrW8query	HpvPXFGrW8corpus	1
KXIrlZWvtIquery	KXIrlZWvtIcorpus	1
wtkHZT8eUlquery	wtkHZT8eUlcorpus	1
USJGAwWhmBquery	USJGAwWhmBcorpus	1
MNvNU6tYecquery	MNvNU6tYeccorpus	1
Dy11VMBgwpquery	Dy11VMBgwpcorpus	1
XlPLGhEyVFquery	XlPLGhEyVFcorpus	1
PLkXaADxgJquery	PLkXaADxgJcorpus	1
HwPFVcXqURquery	HwPFVcXqURcorpus	1
LraHsFBTnSquery	LraHsFBTnScorpus	1
YZWyThRBVequery	YZWyThRBVecorpus	1
ANwesYYWTsquery	ANwesYYWTscorpus	1
mqTBHB1yxmquery	mqTBHB1yxmcorpus	1
PoKwvxECmJquery	PoKwvxECmJcorpus	1
IIRbfvFyFcquery	IIRbfvFyFccorpus	1
NZFhBmFmpbquery	NZFhBmFmpbcorpus	1
gqrBIQeBTUquery	gqrBIQeBTUcorpus	1
nYsgYyVtIMquery	nYsgYyVtIMcorpus	1
zPQzUshHlwquery	zPQzUshHlwcorpus	1
srbMm2uRubquery	srbMm2uRubcorpus	1
HRJvggeljWquery	HRJvggeljWcorpus	1
MbtSojZOidquery	MbtSojZOidcorpus	1
OMwezpVMScquery	OMwezpVMSccorpus	1
yeUcrMBQFtquery	yeUcrMBQFtcorpus	1
MHAiKQSQXvquery	MHAiKQSQXvcorpus	1
0QrPioiTOmquery	0QrPioiTOmcorpus	1
wlkoYLXsqSquery	wlkoYLXsqScorpus	1
BVQEGmNETUquery	BVQEGmNETUcorpus	1
RegTLbZaEUquery	RegTLbZaEUcorpus	1
MvDdkDy0Kuquery	MvDdkDy0Kucorpus	1
ahEOXLLkjFquery	ahEOXLLkjFcorpus	1
TbEXtQHaOqquery	TbEXtQHaOqcorpus	1
JpJo5UspdDquery	JpJo5UspdDcorpus	1
LbHRdYovewquery	LbHRdYovewcorpus	1
FcnaVQo19pquery	FcnaVQo19pcorpus	1
FsSoOHoiYequery	FsSoOHoiYecorpus	1
CmoUOSqknBquery	CmoUOSqknBcorpus	1
fouHaDs6BVquery	fouHaDs6BVcorpus	1
pAQl6TT0IFquery	pAQl6TT0IFcorpus	1
vGWXMcntaCquery	vGWXMcntaCcorpus	1
NpBXGKZaKkquery	NpBXGKZaKkcorpus	1
AznCymdUUVquery	AznCymdUUVcorpus	1
NIgaZffWdXquery	NIgaZffWdXcorpus	1
AagqFXNdexquery	AagqFXNdexcorpus	1
xNVlnpeAWlquery	xNVlnpeAWlcorpus	1
PXEbAj9mzhquery	PXEbAj9mzhcorpus	1
uwkFCheAdRquery	uwkFCheAdRcorpus	1
0NVwcQmxDoquery	0NVwcQmxDocorpus	1
GqaVKQILFsquery	GqaVKQILFscorpus	1
HvysvkAhczquery	HvysvkAhczcorpus	1
isUYKifMSfquery	isUYKifMSfcorpus	1
gpKA4hqOXequery	gpKA4hqOXecorpus	1
fDlEdkNmfwquery	fDlEdkNmfwcorpus	1
bfpRWNIojdquery	bfpRWNIojdcorpus	1
YsymPAcgdAquery	YsymPAcgdAcorpus	1
nweOXGjyk0query	nweOXGjyk0corpus	1
G9erseJSDQquery	G9erseJSDQcorpus	1
LlfZGzDjnhquery	LlfZGzDjnhcorpus	1
xQzqpHEmMoquery	xQzqpHEmMocorpus	1
NirwiawuNFquery	NirwiawuNFcorpus	1
doKLgvxRAaquery	doKLgvxRAacorpus	1
rtuXbhYOLfquery	rtuXbhYOLfcorpus	1
micDSKAcEAquery	micDSKAcEAcorpus	1
vzSjvNcnIKquery	vzSjvNcnIKcorpus	1
bWkUXHjsBxquery	bWkUXHjsBxcorpus	1
azVswtqqyDquery	azVswtqqyDcorpus	1
bRfoSsXh6Nquery	bRfoSsXh6Ncorpus	1
uvYguNf9RUquery	uvYguNf9RUcorpus	1
IeFjFLDNhqquery	IeFjFLDNhqcorpus	1
O9wDXIpfEzquery	O9wDXIpfEzcorpus	1
rQlXPGImopquery	rQlXPGImopcorpus	1
GxzvEeybJZquery	GxzvEeybJZcorpus	1
RRdIhPArOVquery	RRdIhPArOVcorpus	1
DvPBaKneNFquery	DvPBaKneNFcorpus	1
hnpuknzfOmquery	hnpuknzfOmcorpus	1
CGnNveLDSSquery	CGnNveLDSScorpus	1
2xTuFOclwsquery	2xTuFOclwscorpus	1
XiTeMFkZlWquery	XiTeMFkZlWcorpus	1
riXWJHzLUgquery	riXWJHzLUgcorpus	1
hfNSEDtxgZquery	hfNSEDtxgZcorpus	1
uf7EgxBHQYquery	uf7EgxBHQYcorpus	1
iKUWsMlxVkquery	iKUWsMlxVkcorpus	1
jqOUvKoUqRquery	jqOUvKoUqRcorpus	1
oeqGVJcbZjquery	oeqGVJcbZjcorpus	1
ESMvfFTNlCquery	ESMvfFTNlCcorpus	1
FNA7YoGaaoquery	FNA7YoGaaocorpus	1
pjlUyLgxxSquery	pjlUyLgxxScorpus	1
qRgAovS6Unquery	qRgAovS6Uncorpus	1
bGmCGaRrDRquery	bGmCGaRrDRcorpus	1
ho5hsWziQUquery	ho5hsWziQUcorpus	1
YGPq4FcCvHquery	YGPq4FcCvHcorpus	1
sHEgpfH2WZquery	sHEgpfH2WZcorpus	1
dzDHTkhNjUquery	dzDHTkhNjUcorpus	1
gQSZMILSKkquery	gQSZMILSKkcorpus	1
JxSblLUTrequery	JxSblLUTrecorpus	1
VydAzSIARyquery	VydAzSIARycorpus	1
YJbAQelpPYquery	YJbAQelpPYcorpus	1
gRiMIvUYJyquery	gRiMIvUYJycorpus	1
SRGuDcXCFwquery	SRGuDcXCFwcorpus	1
RFglMLS5fdquery	RFglMLS5fdcorpus	1
HFrschkajRquery	HFrschkajRcorpus	1
HzDUZfigLgquery	HzDUZfigLgcorpus	1
bGJfwABRukquery	bGJfwABRukcorpus	1
dBIJNLS3Cuquery	dBIJNLS3Cucorpus	1
gXAPBk5sYnquery	gXAPBk5sYncorpus	1
dQpIyt6EHSquery	dQpIyt6EHScorpus	1
dDoqvyGEZEquery	dDoqvyGEZEcorpus	1
XGmXsdBttfquery	XGmXsdBttfcorpus	1
vbVXYezQNlquery	vbVXYezQNlcorpus	1
jCGSISx7iDquery	jCGSISx7iDcorpus	1
V9EdNEkXGdquery	V9EdNEkXGdcorpus	1
ZhGoFYMfrIquery	ZhGoFYMfrIcorpus	1
PLmLBzAASequery	PLmLBzAASecorpus	1
vMrYmSHKFSquery	vMrYmSHKFScorpus	1
zVGiMkeyYxquery	zVGiMkeyYxcorpus	1
oifEAWADUfquery	oifEAWADUfcorpus	1
IcIjVoZmdcquery	IcIjVoZmdccorpus	1
tBtFzsvOEJquery	tBtFzsvOEJcorpus	1
qinamHPgOyquery	qinamHPgOycorpus	1
LQwOriukoiquery	LQwOriukoicorpus	1
cJlGMhZQOqquery	cJlGMhZQOqcorpus	1
OLzcKIGB3Yquery	OLzcKIGB3Ycorpus	1
FPUCwDArFsquery	FPUCwDArFscorpus	1
CEovTNhlhZquery	CEovTNhlhZcorpus	1
EN6iFbGFePquery	EN6iFbGFePcorpus	1
NfhEaQcRXuquery	NfhEaQcRXucorpus	1
FwtycxScMpquery	FwtycxScMpcorpus	1
wJM5QZLAonquery	wJM5QZLAoncorpus	1
fjRWX2FuUsquery	fjRWX2FuUscorpus	1
WF4JGYagSyquery	WF4JGYagSycorpus	1
zeLbJCgeWZquery	zeLbJCgeWZcorpus	1
ttgXjuIkVQquery	ttgXjuIkVQcorpus	1
OeqgiaIHJBquery	OeqgiaIHJBcorpus	1
FX7faXKCEfquery	FX7faXKCEfcorpus	1
TypiSoIymnquery	TypiSoIymncorpus	1
HbeyeWob9nquery	HbeyeWob9ncorpus	1
KDbjNiYPsvquery	KDbjNiYPsvcorpus	1
nBwOMvw1Jxquery	nBwOMvw1Jxcorpus	1
qirJzmmiQUquery	qirJzmmiQUcorpus	1
1EkAevXrEgquery	1EkAevXrEgcorpus	1
zFUSSfArINquery	zFUSSfArINcorpus	1
kzSqvkJPMGquery	kzSqvkJPMGcorpus	1
uZXfomHCRSquery	uZXfomHCRScorpus	1
aZORmtgoUOquery	aZORmtgoUOcorpus	1
lhZivJRQFCquery	lhZivJRQFCcorpus	1
nZsManFnHrquery	nZsManFnHrcorpus	1
RYiIxJaEtNquery	RYiIxJaEtNcorpus	1
awDnFaYsTTquery	awDnFaYsTTcorpus	1
GRAJIjqpElquery	GRAJIjqpElcorpus	1
JaFKvuedgDquery	JaFKvuedgDcorpus	1
tArTg5YchRquery	tArTg5YchRcorpus	1
mzNUSkgVbvquery	mzNUSkgVbvcorpus	1
EGdPdyrKhdquery	EGdPdyrKhdcorpus	1
aQcuTnJhgYquery	aQcuTnJhgYcorpus	1
ImLadrZPVJquery	ImLadrZPVJcorpus	1
mQYNgIzpKkquery	mQYNgIzpKkcorpus	1
TGKwcjjeCUquery	TGKwcjjeCUcorpus	1
YOJLDOWZqzquery	YOJLDOWZqzcorpus	1
atwnp4lNXiquery	atwnp4lNXicorpus	1
XdAbYZJktlquery	XdAbYZJktlcorpus	1
uAxigxqzKNquery	uAxigxqzKNcorpus	1
SHLwDLSZTMquery	SHLwDLSZTMcorpus	1
Zgtymzt8fFquery	Zgtymzt8fFcorpus	1
unqdPDvcFlquery	unqdPDvcFlcorpus	1
LvnLNeircxquery	LvnLNeircxcorpus	1
DO4lpOZTrIquery	DO4lpOZTrIcorpus	1
gqiacmwgnPquery	gqiacmwgnPcorpus	1
VMnxeMGXIpquery	VMnxeMGXIpcorpus	1
faYQKJqNgiquery	faYQKJqNgicorpus	1
PqEBCDnLLEquery	PqEBCDnLLEcorpus	1
BmvnnJfuEUquery	BmvnnJfuEUcorpus	1
whscNgPQKBquery	whscNgPQKBcorpus	1
jxUMCjsZhiquery	jxUMCjsZhicorpus	1
fGmKpOQxhfquery	fGmKpOQxhfcorpus	1
bYMLNreKfvquery	bYMLNreKfvcorpus	1
Vuz9bKxSaNquery	Vuz9bKxSaNcorpus	1
zFGhsOVIeFquery	zFGhsOVIeFcorpus	1
nhDsjufYGhquery	nhDsjufYGhcorpus	1
dDpGrwxQDVquery	dDpGrwxQDVcorpus	1
DQHECnOCBBquery	DQHECnOCBBcorpus	1
btaIrxdHExquery	btaIrxdHExcorpus	1
xXzcvAdDKAquery	xXzcvAdDKAcorpus	1
4nhX4luchNquery	4nhX4luchNcorpus	1
rgggzAZmOJquery	rgggzAZmOJcorpus	1
XgEOaV9QjDquery	XgEOaV9QjDcorpus	1
ZMrjRbJuJZquery	ZMrjRbJuJZcorpus	1
UoxSOKtFwkquery	UoxSOKtFwkcorpus	1
IbdOsXcBNCquery	IbdOsXcBNCcorpus	1
NllcPELoxxquery	NllcPELoxxcorpus	1
gHvxqQAaEjquery	gHvxqQAaEjcorpus	1
BwDiabHUxgquery	BwDiabHUxgcorpus	1
ZAZpVntfRsquery	ZAZpVntfRscorpus	1
PtSPvUiesTquery	PtSPvUiesTcorpus	1
xmWPvjo4Awquery	xmWPvjo4Awcorpus	1
yAgkbCdXFGquery	yAgkbCdXFGcorpus	1
mOKrHJAsYMquery	mOKrHJAsYMcorpus	1
cOTcRjcGjFquery	cOTcRjcGjFcorpus	1
kJaXqiNySWquery	kJaXqiNySWcorpus	1
bbhqoXScSiquery	bbhqoXScSicorpus	1
isFDWhLZyfquery	isFDWhLZyfcorpus	1
2xgTNFnsurquery	2xgTNFnsurcorpus	1
mSlCdniDVaquery	mSlCdniDVacorpus	1
qYRAVwkTqiquery	qYRAVwkTqicorpus	1
SsWgLltp4Bquery	SsWgLltp4Bcorpus	1
zLUGchEicMquery	zLUGchEicMcorpus	1
vfNbbfvulbquery	vfNbbfvulbcorpus	1
iwbACCGSUrquery	iwbACCGSUrcorpus	1
UyQrQHNrltquery	UyQrQHNrltcorpus	1
iAplJwVedcquery	iAplJwVedccorpus	1
bjblCVdvUgquery	bjblCVdvUgcorpus	1
ZCxNtdPrSCquery	ZCxNtdPrSCcorpus	1
oYPUqnyQkKquery	oYPUqnyQkKcorpus	1
FMCMPPtKXyquery	FMCMPPtKXycorpus	1
gBVgqkczcCquery	gBVgqkczcCcorpus	1
XWsiKpvSNNquery	XWsiKpvSNNcorpus	1
yMiPSzjSPVquery	yMiPSzjSPVcorpus	1
oXxDHNTqawquery	oXxDHNTqawcorpus	1
gEsgKLqvysquery	gEsgKLqvyscorpus	1
JDXmlQfiYcquery	JDXmlQfiYccorpus	1
leWGnNkHUPquery	leWGnNkHUPcorpus	1
zZ5sREfrCcquery	zZ5sREfrCccorpus	1
cVXqMLvDNrquery	cVXqMLvDNrcorpus	1
JzZVvYOktwquery	JzZVvYOktwcorpus	1
inePILUWYnquery	inePILUWYncorpus	1
uAVInJrvBYquery	uAVInJrvBYcorpus	1
UDcLmHaVNoquery	UDcLmHaVNocorpus	1
JcWTkygWtLquery	JcWTkygWtLcorpus	1
fCELAqXOAnquery	fCELAqXOAncorpus	1
